15 11
13 5
1 2 2 2 2 2 B 0 A 2 B 0 A 2 3
4 0 0 0 0 0 0 0 0 0 0 0 0 0 5
4 0 E F G 0 0 0 0 0 0 0 0 0 5
4 0 H I J 0 0 0 0 0 0 0 0 0 5
4 0 H I J 0 0 0 0 0 0 0 0 0 A
4 0 H I J 0 0 0 0 0 0 0 0 0 0
4 0 H I J 0 0 0 0 0 0 0 0 0 C
4 0 H I J 0 0 0 0 0 0 0 0 0 5
4 0 K L M 0 0 0 0 0 0 0 0 0 5
4 0 0 0 0 0 0 0 0 0 0 0 0 0 5
6 7 7 7 7 7 7 7 D 0 C 7 7 7 8