14 9
1 2 2 2 2 2 2 2 2 2 2 2 2 3
4 0 0 0 0 0 0 0 0 0 0 0 0 5
4 0 0 0 0 0 0 0 0 0 0 0 0 5
B 0 0 0 0 0 0 0 0 0 0 0 0 A
0 0 0 0 0 0 0 0 0 0 0 0 0 0
D 0 0 0 0 0 0 0 0 0 0 0 0 C
4 0 0 0 0 0 0 0 0 0 0 0 0 5
4 0 0 0 0 0 0 0 0 0 0 0 0 5
6 7 7 7 7 7 D C 7 7 7 7 7 8