22 14
1 2 2 2 2 2 B 0 0 A 2 2 2 3 1 2 2 2 2 2 2 3
4 0 0 0 0 0 0 0 0 0 0 0 0 5 4 0 0 0 0 0 0 5
4 0 0 0 0 0 0 0 0 0 0 0 0 5 4 0 0 0 0 0 0 5
4 0 0 0 0 0 0 0 0 0 0 0 0 5 4 0 0 0 0 0 0 5
4 0 0 0 0 0 0 0 0 0 0 0 0 5 4 0 0 0 0 0 0 A
4 0 0 0 0 0 0 0 0 0 0 0 0 5 4 0 0 0 0 0 0 0
4 0 0 0 0 0 0 0 0 0 0 0 0 5 4 0 0 0 0 0 0 C
4 0 0 0 0 0 0 0 0 0 0 0 0 5 4 0 0 0 0 0 0 5
4 0 0 0 0 0 0 0 0 0 0 0 0 5 6 7 7 7 7 7 7 8
4 0 0 0 0 0 0 0 0 0 0 0 0 5 1 2 2 2 2 2 2 3
4 0 0 0 0 0 0 0 0 0 0 0 0 5 4 0 0 0 0 0 0 5
4 0 0 0 0 0 0 0 0 0 0 0 0 5 4 0 0 0 0 0 0 5
4 0 0 0 0 0 0 0 0 0 0 0 0 5 4 0 0 0 0 0 0 5
6 7 7 7 7 7 7 7 7 7 7 7 7 8 6 7 7 7 7 7 7 8