1 2 2 2 2 2 2 2 2 2 2 2 2 3
4 0 0 0 0 0 0 0 0 0 0 0 0 5
4 0 E F F F F F F F F G 0 5
B 0 H I I I I I I I I J 0 A
0 0 H I I I I I I I I J 0 0
D 0 H I I I I I I I I J 0 C
4 0 K L L L L L L L L M 0 5
4 0 0 0 0 0 0 0 0 0 0 0 0 5
6 7 7 7 7 7 7 7 7 7 7 7 7 8